202111049
202111172
202111918
202010042
202010443
202010486
202010792
202010830
202010855
202010979
202011132
202011137
202011146
202011424
202011601
201811221
201811226
201811266
201811294
202013548
201911204
201911264
201911285
201911295
201911296
201911297
201911299
202113554
hanaki
